[
    [
        [" ", " ", "w", "w", "w", "w", "w", " ", " ", " ", " ", " ", " ", " ", " ", " ", " ", " ", " ", " "],
        [" ", " ", "w", " ", " ", " ", "w", " ", "w", "w", "w", " ", " ", " ", " ", " ", " ", " ", " ", " "],
        [" ", " ", "w", "w", "w", " ", "w", "w", "w", "e", "w", " ", " ", " ", " ", "w", "w", "w", " ", " "],
        [" ", " ", " ", " ", "w", " ", " ", " ", " ", " ", "w", "w", "w", "w", "w", "w", " ", "w", " ", " "],
        [" ", " ", " ", " ", "w", "w", " ", " ", " ", " ", " ", " ", " ", " ", "w", " ", " ", "w", " ", " "],
        [" ", " ", "w", "w", "w", " ", " ", " ", " ", " ", " ", " ", " ", " ", " ", " ", "w", "w", " ", " "],
        [" ", " ", "w", " ", " ", " ", " ", " ", " ", " ", " ", " ", " ", " ", "w", " ", "w", " ", " ", " "],
        [" ", " ", "w", "aa", "w", "w", "w", "w", " ", " ", " ", " ", " ", " ", "w", "w", "w", " ", " ", " "],
        [" ", " ", "w", "r", "w", " ", " ", "w", "w", "w", "w", " ", " ", " ", "w", " ", " ", " ", " ", " "],
        [" ", " ", "w", "w", "w", " ", " ", " ", " ", " ", "w", "w", "w", "w", "w", " ", " ", " ", " ", " "],
        [" ", " ", " ", " ", " ", " ", " ", " ", " ", " ", " ", " ", " ", " ", " ", " ", " ", " ", " ", " "]
    ],
    [
        [" ", " ", " ", " ", " ", " ", " ", " ", " ", " ", " ", " ", " ", " ", " ", " ", " ", " ", " ", " "],
        [" ", " ", " ", " ", " ", " ", " ", "w", "w", "w", "w", "w", "w", "w", "w", "w", "w", "w", " ", " "],
        [" ", " ", " ", " ", " ", " ", " ", "w", "w", "w", " ", " ", " ", " ", "r", " ", " ", "w", " ", " "],
        [" ", " ", " ", " ", " ", " ", "w", "w", " ", " ", " ", " ", " ", "t", "t", " ", "p", "w", " ", " "],
        [" ", " ", " ", " ", " ", " ", "w", " ", " ", " ", " ", " ", "t", "t", " ", " ", " ", "w", " ", " "],
        [" ", " ", " ", " ", " ", " ", "w", " ", " ", " ", "al", "al", "t", "t", " ", "w", "w", "w", " ", " "],
        [" ", " ", " ", " ", " ", " ", "w", "e", "t", "g", "g", "al", "t", " ", "w", "w", " ", " ", " ", " "],
        [" ", " ", " ", " ", " ", " ", "w", "t", "t", "t", " ", " ", " ", "w", "w", " ", " ", " ", " ", " "],
        [" ", " ", " ", " ", " ", " ", "w", "w", "w", "w", " ", " ", "w", "w", " ", " ", " ", " ", " ", " "],
        [" ", " ", " ", " ", " ", " ", " ", " ", " ", "w", "w", "w", "w", " ", " ", " ", " ", " ", " ", " "],
        [" ", " ", " ", " ", " ", " ", " ", " ", " ", " ", " ", " ", " ", " ", " ", " ", " ", " ", " ", " "]
    ],
    [
        [" ", " ", " ", " ", " ", " ", " ", " ", " ", " ", " ", " ", " ", " ", " ", " ", " ", " ", " ", " "],
        [" ", " ", " ", " ", "w", "w", "w", "w", "w", "w", "w", "w", "w", "w", "w", "w", "w", " ", " ", " "],
        [" ", " ", " ", "w", "w", " ", "w", " ", "w", "av", " ", "w", "av", "w", "av", "r", "w", " ", " ", " "],
        [" ", " ", " ", "w", " ", " ", " ", " ", " ", " ", " ", " ", " ", " ", "aa", " ", "w", " ", " ", " "],
        [" ", " ", " ", "w", "w", " ", " ", " ", " ", " ", " ", " ", " ", " ", " ", "w", "w", " ", " ", " "],
        [" ", " ", " ", " ", "w", "w", " ", " ", " ", " ", " ", " ", " ", " ", "w", "w", " ", " ", " ", " "],
        [" ", " ", " ", "w", "w", "av", " ", " ", " ", " ", " ", " ", " ", " ", "aa", "w", "w", " ", " ", " "],
        [" ", " ", " ", "w", " ", " ", " ", " ", " ", " ", " ", " ", " ", " ", " ", " ", "w", " ", " ", " "],
        [" ", " ", " ", "w", "e", " ", "w", "av", "w", " ", "av", "w", " ", "w", " ", "w", "w", " ", " ", " "],
        [" ", " ", " ", "w", "w", "w", "w", "w", "w", "w", "w", "w", "w", "w", "w", "w", " ", " ", " ", " "],
        [" ", " ", " ", " ", " ", " ", " ", " ", " ", " ", " ", " ", " ", " ", " ", " ", " ", " ", " ", " "]
    ]
]
